32
18
001:003:008
001:013:001
002:010:006
002:010:002
001:003:007
001:004:008
002:007:001
