32
18
001:003:008
001:013:001
002:010:006
002:010:002
002:007:001
002:007:002
002:007:003
002:007:004
002:007:005
002:007:006
002:007:007
001:003:007
001:004:008
